1111111111
10000P0001
1000000001
10C0001101
1000000011
1000000011
1000000011
1000000011
1000000011
1000000011
1000000011
1000000011
1000000011
1000000011
1000000011
1000000011
1000000011
1000000011
1000000011
1000000011
1000000011
1000000011
1000000011
1000000011
1111111111

